1,1,1,1,1,1,1,1,3,3,3,3,4,4,4,4,4,4,4,4,1,3,3,3,3,5,5,5,5,3,3,1,4,4,4,4,4,4,4,4,1,1,1,1,3,3,3,3,3,2,2,3,3,3,3,3,3,3,3,3,3,3,3,3,3,3,3,3,3,3,1,4,4,4,4,1,1,1,1,4,4,-1
4,4,4,4,1,3,3,3,3,1,3,3,1,4,4,4,4,4,4,4,1,3,3,3,3,5,5,5,5,3,3,1,4,4,4,4,4,4,4,4,1,-1,1,3,3,3,3,3,1,1,1,3,1,1,1,3,3,3,3,3,3,3,3,3,3,3,3,3,3,3,1,4,4,4,4,1,3,3,1,4,4,-1
4,4,4,1,1,1,1,3,3,1,3,3,1,4,1,1,1,4,4,4,1,2,3,3,3,5,5,5,5,3,1,1,4,4,4,1,1,1,2,2,2,1,3,3,3,3,3,3,3,3,1,1,1,4,1,1,3,3,3,3,3,3,3,3,3,3,3,3,3,3,1,4,4,4,4,1,3,3,1,4,4,-1
4,4,4,1,1,1,3,3,3,1,3,3,1,1,1,1,4,4,4,4,4,2,3,3,5,5,5,5,5,3,1,4,4,4,4,1,1,1,3,3,3,3,3,3,3,3,3,3,3,1,1,4,4,4,4,1,3,3,3,3,3,3,3,3,3,3,3,3,3,1,4,4,4,4,1,1,3,1,4,4,4,-1
4,4,1,1,3,3,3,3,1,1,3,3,3,3,3,1,1,4,4,4,4,2,3,3,5,5,5,5,5,3,1,4,4,4,4,1,2,2,3,3,3,3,3,3,3,3,3,3,3,2,1,1,1,1,2,3,3,3,3,3,3,3,3,3,3,3,3,3,1,1,4,4,4,1,1,3,3,1,4,4,4,-1
4,4,1,3,3,3,3,3,1,1,3,3,3,3,3,3,1,1,1,1,1,2,3,3,5,5,5,5,5,3,1,1,4,4,4,2,3,3,3,3,3,3,3,3,3,3,3,3,3,3,3,3,1,1,3,3,3,3,3,3,3,3,3,3,3,3,3,1,1,4,4,4,4,1,3,3,1,1,4,4,4,-1
4,1,3,3,3,3,3,3,1,1,3,3,1,3,3,3,3,1,1,3,1,2,3,3,5,5,5,5,5,3,1,1,4,4,1,2,3,3,3,3,3,3,3,3,3,3,3,3,3,3,3,3,3,3,3,3,3,3,3,3,3,3,3,3,3,3,3,1,4,4,4,4,1,3,3,3,1,4,4,4,4,-1
4,1,3,3,3,3,3,1,1,3,3,3,1,1,1,1,3,3,3,3,3,3,3,3,5,5,5,5,5,3,3,1,4,4,2,3,3,3,3,3,3,3,3,3,3,3,3,3,3,3,3,3,3,3,3,3,3,3,2,3,3,3,3,3,3,1,1,1,4,4,4,4,1,3,3,3,1,4,4,4,4,-1
4,1,3,3,3,3,3,3,3,3,3,3,1,4,4,1,1,3,3,3,3,3,3,3,5,5,5,5,5,3,3,3,1,4,2,3,3,3,3,3,3,3,3,3,3,3,3,3,3,3,3,3,3,3,3,3,3,3,3,3,3,3,3,3,3,3,1,1,4,4,4,4,1,3,3,3,1,1,1,1,1,-1
4,1,3,3,3,3,3,3,3,3,3,3,1,4,4,4,1,1,3,3,3,3,3,3,5,5,5,5,5,5,3,3,2,2,2,3,3,3,3,3,3,3,3,3,3,3,3,3,3,3,3,3,3,3,3,3,3,3,3,3,3,2,3,3,3,3,1,1,1,1,4,4,1,1,3,3,3,3,3,3,1,-1
4,1,3,3,3,3,3,3,3,3,3,3,1,4,4,4,4,1,1,1,1,1,3,3,3,5,5,5,5,5,5,3,3,3,3,3,3,3,3,3,3,3,3,3,3,3,3,3,3,3,3,3,3,3,3,3,3,3,3,3,2,3,3,3,3,3,1,1,3,1,4,4,1,1,3,3,3,3,1,3,1,-1
4,1,1,3,3,3,3,3,3,3,3,3,1,4,4,4,4,4,4,4,4,1,1,3,3,5,5,5,5,5,5,5,5,5,5,3,3,3,3,3,3,3,3,3,3,3,3,3,3,3,3,3,3,3,3,3,3,3,3,3,3,3,3,3,3,3,3,1,3,1,1,1,3,3,3,3,3,1,1,1,1,-1
4,4,1,3,3,3,3,3,3,3,3,3,1,4,4,4,4,4,4,4,4,4,1,3,3,3,5,5,5,5,5,5,5,5,5,3,3,3,3,3,3,3,3,3,3,3,3,3,3,3,3,3,3,3,3,3,3,2,3,2,3,3,3,3,3,3,3,3,3,3,1,1,1,3,3,3,3,3,1,4,4,-1
4,4,1,1,1,3,3,3,3,3,3,3,1,4,4,4,4,4,4,4,4,4,1,1,3,3,5,5,5,5,5,5,5,5,5,3,3,3,3,3,3,3,3,3,3,3,3,3,3,3,3,3,3,3,3,3,2,3,1,1,1,3,3,3,3,3,3,3,1,3,1,1,1,3,3,3,1,1,1,4,4,-1
4,4,4,4,1,1,3,3,3,3,3,3,1,4,4,4,4,4,4,4,4,4,4,1,3,3,3,5,5,5,5,5,5,5,5,3,3,3,3,3,3,3,3,3,3,3,3,3,3,3,3,3,3,3,3,3,3,3,1,1,3,3,3,3,3,3,3,1,1,3,1,1,3,3,3,3,1,4,4,4,4,-1
4,4,4,4,4,1,1,1,1,3,3,3,1,4,4,4,4,4,4,4,4,4,4,1,1,3,3,5,5,5,5,5,5,5,5,3,3,3,3,3,3,3,3,3,3,3,3,3,3,3,3,3,3,3,3,3,3,3,3,1,1,3,3,3,3,3,3,1,3,3,3,3,3,3,3,3,1,4,4,4,4,-1
4,4,4,4,4,4,1,1,1,3,3,3,1,4,4,4,4,4,4,4,4,4,4,4,1,3,3,5,5,5,5,5,5,5,5,3,3,3,3,3,3,3,3,3,3,3,3,3,3,3,3,3,3,3,3,3,1,1,3,3,1,1,3,3,3,3,3,3,1,3,3,3,3,1,3,1,1,4,4,4,4,-1
4,4,4,4,4,4,4,4,1,3,3,3,1,4,4,4,4,4,4,4,4,4,4,4,1,1,3,5,5,5,5,5,5,5,5,3,3,3,3,3,3,3,3,3,3,3,3,3,3,3,3,3,3,3,3,2,1,1,3,3,1,1,3,3,3,1,1,1,1,1,1,1,1,1,1,1,1,4,4,4,4,-1
4,4,4,4,4,4,4,4,1,3,3,3,1,4,4,4,4,4,4,4,4,4,4,4,4,1,2,3,5,5,5,5,5,5,5,3,3,3,3,3,3,3,3,3,3,3,3,3,3,3,3,3,3,3,3,3,1,1,3,2,1,1,1,3,3,1,4,4,4,4,4,4,4,4,4,4,4,4,4,4,4,-1
4,4,4,4,4,4,4,1,1,3,3,3,1,4,4,4,4,4,4,4,4,4,4,4,1,1,3,5,5,5,5,5,5,5,5,3,3,3,3,3,3,3,3,3,3,3,3,3,3,3,3,7,7,7,3,1,1,3,3,1,4,1,3,3,3,1,4,4,4,4,4,4,4,4,4,4,4,4,4,4,4,-1
4,4,4,4,4,4,4,4,4,1,1,1,1,4,4,4,4,4,4,1,1,1,1,1,3,3,3,3,3,5,5,5,5,5,5,3,3,3,3,3,3,3,3,3,3,3,3,3,7,7,7,7,7,3,3,3,1,3,1,1,1,1,2,3,1,4,4,4,4,4,4,4,4,4,4,4,4,4,4,4,4,-1
4,4,4,4,4,4,4,4,4,4,4,4,4,4,4,4,4,1,1,1,3,3,3,3,3,1,1,3,3,5,5,5,5,5,5,3,3,3,3,3,3,3,3,3,3,3,3,7,7,7,7,7,7,7,3,3,3,3,2,3,3,3,3,3,1,4,4,4,4,4,4,4,4,4,4,4,4,4,4,4,4,-1
4,4,4,4,4,4,4,4,4,4,4,4,4,4,4,4,1,1,3,3,3,3,3,3,1,1,1,2,3,5,5,5,5,5,5,3,3,3,3,3,3,3,7,7,7,7,7,7,7,7,7,7,7,7,3,3,3,3,3,3,3,1,1,4,4,4,4,4,4,4,4,4,4,4,4,4,4,4,4,4,4,-1
4,4,4,4,4,4,4,4,4,4,4,4,4,4,4,4,1,3,3,1,1,3,3,3,1,1,1,2,3,5,5,5,5,5,3,3,3,3,3,7,7,7,7,7,7,7,7,7,7,7,7,7,7,3,3,3,3,3,3,2,2,1,4,4,4,4,4,4,4,4,4,4,4,4,4,4,4,4,4,4,4,-1
4,4,4,4,4,4,4,4,4,4,4,4,4,4,4,1,3,3,1,1,1,3,3,1,3,3,3,2,3,5,5,5,5,5,3,3,3,3,7,7,7,7,7,7,7,7,7,7,7,7,7,7,7,3,3,3,3,3,3,3,3,1,4,4,4,4,4,4,4,1,1,1,4,4,4,4,4,4,4,4,4,-1
4,4,4,4,4,4,4,4,4,4,4,4,4,4,4,1,1,1,1,1,1,1,3,3,3,5,5,5,5,5,5,3,3,3,3,7,7,7,7,7,7,7,7,7,7,7,7,7,7,7,7,7,7,7,3,3,3,3,3,3,3,1,4,4,4,4,4,4,4,1,3,1,1,4,4,4,4,4,4,1,1,-1
4,4,4,4,4,4,4,4,4,4,4,4,4,4,4,4,1,1,1,3,1,1,1,3,3,5,5,5,5,5,5,3,3,3,7,7,7,7,7,7,7,7,7,7,7,7,7,7,7,7,7,7,7,7,3,3,3,3,3,3,3,1,4,4,4,4,1,1,2,1,3,3,1,1,1,4,4,4,4,1,3,-1
4,4,4,4,4,4,4,4,4,4,4,4,4,4,4,1,1,3,3,1,2,3,3,3,5,5,5,6,6,6,6,6,6,7,7,7,7,7,7,7,7,7,7,7,7,7,7,7,7,7,7,7,7,5,5,3,2,2,1,1,1,1,4,1,1,2,1,3,3,1,1,3,3,3,1,4,4,4,4,1,3,-1
4,4,4,4,4,4,4,4,4,4,4,4,4,1,1,1,3,3,3,3,3,3,3,6,6,6,6,6,6,6,6,6,6,7,7,7,7,7,7,7,7,7,7,7,7,3,3,3,5,5,5,5,5,5,5,3,2,4,4,4,4,4,4,2,3,3,3,2,3,1,1,3,3,3,2,4,4,4,4,1,3,-1
4,4,4,4,4,4,4,4,4,4,4,4,4,1,3,1,3,6,6,6,6,6,6,6,6,6,6,6,6,6,6,6,6,3,3,3,3,3,3,3,3,3,3,3,3,3,3,5,5,5,5,5,5,5,5,3,1,4,4,4,4,1,1,1,3,3,3,3,3,3,1,1,1,3,1,1,1,1,1,1,3,-1
4,4,4,4,4,4,4,4,4,4,4,1,1,1,3,3,3,6,6,6,6,6,6,6,6,6,6,6,6,3,3,3,3,3,3,3,3,3,3,3,3,3,3,3,3,3,3,5,5,5,5,5,5,5,5,3,2,4,4,4,4,1,3,3,1,3,3,2,2,3,3,3,1,3,3,1,1,3,3,3,1,-1
4,4,4,4,4,4,4,4,4,4,4,1,3,1,3,6,6,6,6,6,6,6,6,6,6,6,3,3,3,3,3,3,3,3,3,3,3,3,3,3,3,3,3,3,3,1,3,5,5,5,5,5,5,5,5,3,1,4,4,4,4,1,3,2,3,3,3,3,3,3,3,3,2,2,3,2,1,3,3,2,1,-1
4,4,4,4,4,4,4,4,4,4,4,1,3,3,3,6,6,6,6,6,6,6,6,3,3,3,3,3,3,3,3,3,3,3,3,3,3,3,3,3,3,3,3,1,2,3,3,5,5,5,5,5,5,5,5,3,2,1,4,4,1,2,3,3,3,3,3,3,3,3,2,2,3,3,3,3,2,3,3,2,1,-1
4,4,4,4,4,4,4,4,4,4,4,1,1,3,3,6,6,6,6,6,6,3,3,3,3,3,3,3,3,3,3,3,3,3,3,3,3,3,3,3,3,3,3,3,3,3,5,5,5,5,5,5,5,5,5,3,3,1,1,2,1,3,3,3,1,1,1,1,1,3,3,3,3,3,3,3,3,3,3,3,1,-1
4,4,4,4,4,4,4,4,4,4,4,4,1,3,6,6,6,6,6,3,3,3,3,3,3,3,3,3,3,3,3,3,3,3,3,3,3,3,3,3,3,3,3,3,3,3,5,5,5,5,5,5,5,5,3,3,3,3,3,3,3,3,1,1,1,4,4,4,1,3,3,3,3,3,3,3,3,2,2,3,3,-1
4,4,4,4,4,4,4,4,4,4,1,1,3,3,6,6,6,6,3,3,3,3,3,3,3,3,3,3,3,3,3,3,3,3,3,3,3,3,3,3,3,3,3,2,3,3,5,5,5,5,5,5,1,5,3,3,3,1,1,1,1,1,1,4,4,4,4,4,1,3,3,3,3,3,3,3,3,3,3,3,3,-1
4,4,4,4,4,4,4,4,1,1,1,3,3,6,6,6,6,3,3,3,3,3,3,3,3,3,3,3,3,3,3,3,3,3,3,3,3,3,3,3,3,3,3,3,3,3,5,5,5,5,2,1,5,5,3,3,1,1,4,4,4,4,4,4,4,4,4,4,1,1,3,3,3,3,3,3,1,3,3,3,3,-1
4,4,4,4,4,4,4,4,1,3,3,3,6,6,6,6,3,3,3,3,3,3,3,3,3,3,3,3,3,3,3,3,3,3,3,3,3,3,3,3,3,3,3,3,3,3,5,5,5,5,5,5,5,3,3,3,1,4,4,4,4,4,4,4,4,4,4,4,4,1,1,1,3,3,1,1,1,1,1,3,3,-1
1,1,1,1,1,1,1,1,1,3,3,6,6,6,6,3,3,3,3,3,3,3,3,3,3,3,3,3,3,3,3,3,3,3,3,3,3,3,3,3,3,3,3,3,3,3,5,5,5,5,5,5,3,3,3,3,1,4,4,4,4,4,4,4,4,4,4,4,4,4,4,1,1,1,1,4,4,4,1,1,1,-1
1,3,3,1,3,3,3,1,1,3,3,6,6,6,3,3,3,3,3,3,3,3,3,3,3,3,3,3,3,3,3,3,3,3,3,3,3,3,3,3,3,3,3,3,3,3,5,5,5,5,3,3,3,3,1,1,4,4,4,4,4,4,4,4,4,4,4,4,4,4,4,4,4,4,4,4,4,4,4,4,4,-1
3,3,3,3,3,3,3,3,1,1,3,3,6,6,3,3,3,3,3,3,3,3,3,3,3,3,3,3,3,3,3,3,3,3,3,3,3,3,3,3,3,3,3,3,3,5,5,5,5,3,2,2,3,3,1,1,4,4,4,4,4,4,4,4,4,4,4,4,4,4,4,4,4,4,4,4,4,4,4,4,4,-1
3,3,3,3,3,3,3,3,1,1,3,3,3,3,3,3,3,3,3,3,3,3,3,3,3,3,3,3,3,3,3,3,3,3,3,3,3,3,3,3,3,3,8,8,5,5,5,5,5,3,3,3,3,1,1,4,4,4,4,4,4,4,4,4,4,4,4,4,4,4,4,4,4,4,4,4,4,4,4,4,4,-1
3,3,3,3,3,3,3,3,3,3,3,2,3,3,3,3,3,3,3,3,3,3,3,3,3,3,3,3,3,3,3,3,3,3,3,3,3,3,3,3,8,8,8,8,5,5,5,5,3,3,3,3,1,1,4,4,4,4,4,4,4,4,4,4,4,4,4,4,4,4,4,4,4,4,4,4,4,4,4,4,4,-1
3,3,3,3,3,3,3,3,3,3,3,3,3,2,3,3,3,3,3,3,3,3,3,3,3,3,3,3,3,3,3,3,3,3,3,8,8,8,8,8,8,8,8,5,5,5,5,5,3,3,3,1,1,4,4,4,4,4,4,4,4,4,4,4,4,4,4,4,4,4,4,4,4,4,4,4,4,4,4,4,4,-1
3,3,3,3,3,3,3,1,1,1,2,3,3,3,2,1,3,3,8,8,8,8,8,8,8,8,8,8,8,8,8,8,8,8,8,8,8,8,8,8,8,8,8,5,5,5,5,3,3,3,3,1,1,4,4,4,4,4,4,4,4,4,4,4,4,4,4,4,4,4,4,4,4,4,4,4,4,4,4,4,4,-1
3,3,3,1,1,3,3,3,3,3,3,1,1,2,3,3,3,3,3,3,3,3,8,8,8,8,8,8,8,8,8,8,8,8,8,8,8,8,8,8,8,8,8,5,5,5,5,3,3,3,3,1,1,4,4,4,4,4,4,4,4,4,4,4,4,4,4,4,4,4,4,4,4,4,4,4,4,4,4,4,4,-1
3,3,1,1,1,3,3,3,3,3,3,3,3,3,3,1,1,3,3,3,3,3,3,8,8,8,8,8,8,8,8,8,8,8,8,8,8,8,8,8,8,8,8,5,5,5,3,3,3,3,1,1,1,4,4,4,4,4,4,4,4,4,4,4,4,4,4,4,4,4,4,4,4,4,4,4,4,4,4,4,4,-1
1,1,1,1,1,3,3,3,3,3,3,1,1,3,1,1,1,1,3,1,3,1,3,3,8,8,8,8,8,8,8,8,8,8,8,8,8,8,8,8,8,8,8,8,8,8,8,8,3,3,3,3,1,4,4,4,4,4,4,4,4,4,4,4,4,4,4,4,4,4,4,4,4,4,4,4,4,4,4,4,4,-1
1,1,1,1,3,3,3,3,3,3,3,3,3,3,3,3,3,3,3,3,3,3,1,3,3,3,8,8,8,8,8,8,8,8,8,8,8,8,8,8,8,8,8,8,8,8,2,2,3,3,3,1,1,4,4,4,4,4,4,4,4,4,4,4,4,4,4,4,4,4,4,4,4,4,4,4,4,4,4,4,4,-1
3,1,1,1,1,1,1,1,1,3,3,3,3,3,3,3,3,3,3,3,3,3,1,3,3,3,8,8,8,8,8,8,8,8,8,8,8,8,8,8,8,8,8,8,8,8,2,1,3,3,3,1,4,4,4,4,4,4,4,4,4,4,4,4,4,4,4,4,4,4,4,4,4,4,4,4,4,4,4,4,4,-1
3,3,3,1,1,1,1,1,3,3,3,3,3,3,3,3,3,3,3,3,3,3,1,3,3,3,3,3,3,3,3,8,8,8,8,8,8,8,8,8,8,8,3,3,3,3,3,3,3,3,3,1,1,4,4,4,4,4,4,4,4,4,4,4,4,4,4,4,4,4,4,4,4,4,4,4,4,4,4,4,4,-1
3,3,3,3,3,3,1,1,3,3,3,3,3,3,3,1,1,3,3,3,3,3,3,3,3,3,1,3,3,3,3,3,3,3,3,3,3,3,3,3,3,3,3,3,3,3,3,3,3,3,3,3,1,1,4,4,4,4,4,4,4,4,4,4,4,4,4,4,4,4,4,4,4,4,4,4,4,4,4,4,4,-1
3,3,3,3,3,3,1,1,1,3,3,3,3,1,1,1,1,1,1,1,1,3,3,3,3,3,3,3,3,3,3,3,3,3,3,3,3,3,3,3,3,3,3,3,3,3,3,3,3,3,3,3,3,1,1,4,4,4,4,4,4,4,4,4,4,4,4,4,4,4,4,4,4,4,4,4,4,4,4,4,4,-1
3,3,3,3,3,3,3,1,1,1,1,1,1,1,4,4,4,4,4,4,1,1,1,3,3,3,3,3,3,3,3,3,3,3,3,3,3,3,3,3,3,3,3,3,3,3,3,3,3,3,3,3,3,3,1,1,1,4,4,4,4,4,4,4,4,4,4,4,4,4,4,4,4,4,4,4,4,4,4,4,4,-1
3,3,3,3,3,3,3,3,3,3,3,1,1,4,4,4,4,4,4,4,4,4,1,1,3,3,3,3,3,3,3,3,3,3,3,3,3,3,3,3,3,3,3,3,3,3,3,3,3,3,3,3,3,3,3,3,1,1,1,4,4,4,4,1,1,1,1,1,1,1,4,4,4,4,4,4,4,4,4,4,4,-1
3,3,3,3,3,3,3,3,3,3,3,1,1,4,4,4,4,4,4,4,4,4,4,1,1,1,1,1,3,3,3,3,3,3,3,3,3,3,3,3,3,3,3,3,3,3,3,3,3,3,3,3,3,3,3,3,3,3,1,1,1,1,1,1,1,3,3,3,1,1,1,1,4,4,4,4,4,4,4,4,4,-1
3,3,3,3,3,3,3,3,3,3,3,3,1,4,4,4,4,4,4,4,4,4,4,4,4,4,4,1,1,3,3,3,3,3,3,3,3,3,3,3,3,3,3,3,3,3,3,3,3,3,3,3,3,3,3,3,3,3,3,3,1,1,3,3,3,3,3,3,3,3,1,1,4,4,4,4,4,4,4,4,4,-1
3,3,3,3,3,3,3,3,3,3,3,1,1,4,4,4,4,4,4,4,4,4,4,4,4,4,4,4,1,1,3,3,3,3,3,3,3,3,3,3,3,3,3,3,3,3,3,3,3,3,3,3,3,3,3,3,3,3,3,3,3,3,3,3,3,3,3,3,3,3,3,1,4,4,4,4,4,4,4,4,4,-1
3,3,1,1,3,3,3,3,3,3,1,1,4,4,4,4,4,4,4,4,4,4,4,4,4,4,4,4,4,1,3,3,3,3,3,3,3,3,3,3,3,3,3,3,3,3,3,3,3,3,3,3,3,3,3,3,3,3,3,3,3,3,3,3,3,3,3,3,3,3,3,1,4,4,4,4,4,4,4,4,4,-1
3,3,1,1,3,3,3,3,3,1,1,4,4,4,4,4,4,4,4,4,4,4,4,4,4,4,4,4,4,1,1,3,3,3,3,3,3,3,3,3,3,3,3,3,3,3,3,3,3,3,3,3,3,3,3,3,3,3,3,3,3,3,3,3,3,3,3,3,3,3,1,1,4,4,4,4,4,4,4,4,4,-1
